################################
#             $$               #
#   $%$   $$      $$   $$  $$  #
#  $$%$$          $$           #
#  %%%%%                       #
#  $$%$$  $  $%%$    $   $$$$  #
#   $%$      $%%$              #
#          $$$%%$$$            #
#       $  %%%%%%%%      $$$$  #
#   $$  $  %%%%%%%%   $        #
#   $$     $$$%%$$$   $        #
#            $%%$        $%$   #
#     $$     $%%$       $$%$$  #
#                   $$  %%%%%  #
#   $$  $$              $$%$$  #
#   $$  $$          $$   $%$   #
#              $$              #
################################